2222222222222
2222222222222
2200000000022
2202220222022
2202000202022
2202041402022
2200016100022
2202041402022
2202020002022
2202220222022
2200000000022
2222222222222
2222222222222

2222222222222
2222222222222
2200002000022
2202202022022
2202006002022
2202014102022
2200042400022
2202014102022
2202000002022
2202202022022
2200002000022
2222222222222
2222222222222

2222222222222
2000000000002
2022220222202
2020000000202
2020401040202
2020014100202
2000146410002
2020014100202
2020401040202
2020000000202
2022220222202
2000000000002
2222222222222

2222222222222
2002222220002
2000000000002
2002204222022
2201200021022
2000204020002
2020002000202
2000204020002
2201206021022
2202224222002
2000000000002
2000222222002
2222222222222

2222222222222
2210202020122
2100400040012
2001200021002
2242224222422
2000200020002
2200406040022
2000200020002
2242224222422
2001200021002
2100400040012
2210202020122
2222222222222

2222222222222
2002000002002
2002024202002
2000000000002
2202020202022
2202021202022
2202021202022
2202021202022
2202021202022
2202021202022
2242422242422
2200006000022
2222222222222

2222222222222
2000000000002
2042402042402
2040000000402
2220202020222
2020212120202
2020212120202
2020212120202
2020212120202
2020212120202
2024242424202
2000006000002
2222222222222

2222222222222
2000000000002
2042420242402
2004000004002
2242040402422
2002121212002
2002121212002
2002121212002
2002121212002
2002121212002
2242424242422
2000006000002
2222222222222

2222222222222
2000000000002
2020202020202
2040404040402
2020212120202
2020212120202
2221202021222
2020212120202
2020212120202
2040404040402
2020202020202
2000006000002
2222222222222

2222222222222
2000000000002
2020202020202
2040404040402
2021212121202
2040212120402
2220212120222
2040212120402
2021212121202
2040404040402
2020202020202
2000006000002
2222222222222

2222222222222
2000000000002
2020202020202
2040404040402
2021212121202
2041212121402
2220402040222
2041212121402
2021212121202
2040404040402
2020202020202
2000006000002
2222222222222

2222222222222
2000000000002
2024202024202
2040000000402
2020202020202
2120404040212
2120202020212
2120404040212
2120202020212
2120202020212
2124242424212
2120006000212
2222222222222

2222222222222
2120002000212
2120204020212
2120402040212
2124202024212
2000002000002
2424046404242
2000002000002
2124202024212
2120402040212
2120204020212
2120002000212
2222222222222

2222222222222
2100400040012
2120204000212
2120404040212
2120222222212
2000040200002
2024026204202
2000020400002
2122222220212
2120404040212
2120004020212
2100400040012
2222222222222

2222222222222
2010100010102
2122242422212
2020002000202
2120404040212
2040002000402
2022422242202
2040002000402
2120404040212
2020002000202
2122242422212
2010106010102
2222222222222

2222222222222
2011100011102
2124242424212
2140002000412
2120404040212
2040002000402
2022422242202
2040002000402
2120404040212
2140002000412
2124242424212
2011106011102
2222222222222

2222222222222
2000011100002
2020222220202
2000402040002
2024004004202
2120002000212
2122422242212
2120002000212
2024004604202
2000402040002
2020222220202
2000011100002
2222222222222

2222222222222
2000114110002
2020222220202
2000402040002
2124004004212
2120002000212
2422422242242
2120002000212
2124004604212
2000402040002
2020222220202
2000114110002
2222222222222

2222222222222
2211104011122
2122202422212
2120004000212
2120400040212
2040044400002
2424046404242
2000044400402
2120400040212
2120004000212
2122242022212
2211104011122
2222222222222

2222222222222
2220002000222
2004002004002
2004002004002
2242422242422
2204002004022
2204002004022
2202200022022
2002220222022
2001120211002
2101106011012
2100020200012
2222222222222

